22222222222222222222222
22111111111111111111122
21000000000000000000012
21000000000000000000012
21000111110001111100012
21000000000000000000012
21000000000000000000012
21000000001110000000012
21000000000000000000012
21000000000000000000012
21000000000000000000012
21000000000000000000012
21000000000000000000012
21000000000000000000012
21000000000000000000012
21000000001110000000012
21000000000000000000012
21000000000000000000012
21000111110001111100012
21000000000000000000012
21000000000000000000012
22111111111111111111122
22222222222222222222222
